сссссссссс
с     *  с
с *  *   с
с        с
с  тт    с
с  тт *  с
с     *  с
c        c
c        c
сссссссссс