сссссссссссссссссссс
с     д    ттттт   с
с д  д       т     с
с          ттттт   с
с  тт              с
с  тт д    ттттт   с
с     д    т т т   с
с   в              с
с  ввв     ттттт   с
с     д            с
с д  д     ттттт   с
с                  с
с  тт       тт     с
с  тт д    т  т    с
с     д     тт     с
с   в              с
с  ввв             с
с                  с
с                  с
сссссссссссссссссссс