сссссссссссссссссссссссссссссссссссссссссссссссссссссссссссссссссссссссссссссccс
с         дттттд        дттттд                   дттттд        дттттд          с
с   д  д   тттт   ввв    тттт 	д  д       д  д   тттт   ввв    тттт 	д  д   с
с   д  д  дттттд  ввв   дттттд	д  д       д  д  дттттд  ввв   дттттд	д  д   с
с   д  д  двттвд  ввв   двттвд	д  д       д  д  двттвд  ввв   двттвд	д  д   с
с   д  д           c    	д  д       д  д           c             д  д   с
с   д  д ттттд    ввв    дтттт	д  д       д  д ттттд    ввв    дтттт	д  д   с
с        ттттд    ввв    дтттт	                ттттд    ввв    дтттт	       с
сс дд дддттттд    ввв    дттттддд дд с  с дд дддттттд    ввв    дттттддд дд   сс
с                       			                               с
с д дддддддд д    ввв    д дддддддд д    д дддддддд д    ввв    д дддддддд д   с
с дт        тд    ввв    дт        тд    дт        тд    ввв    дт        тд   с
с дд дддддд дд    ввв    дд дддддд дд    дд дддддд дд    ввв    дд дддддд дд   с
с дд   дд   дд     c     дд   дд   дд    дд   дд   дд     c     дд   дд   дд   с
с дд д дд д дд    ввв    дд д дд д дд    дд д дд д дд    ввв    дд д дд д дд   с
с дд д дд д дд    ввв    дд д дд д дд    дд д дд д дд    ввв    дд д дд д дд   с
с дд д дд д дд    ввв    дд д дд д дд    дд д дд д дд    ввв    дд д дд д дд   с
с дд д    д дд           дд д    д дд    дд д    д дд           дд д    д дд   с
с дд сттттс дд    ввв    дд сттттс дд    дд сттттс дд    ввв    дд сттттс дд   с
с дд тттттт дд    ввв    дд тттттт дд    дд тттттт дд    ввв    дд тттттт дд   с
с дд сттттс дд    ввв    дд сттттс дд    дд сттттс дд    ввв    дд сттттс дд   с
с дд д    д дд           дд д    д дд    дд д    д дд           дд д    д дд   с
с дд д дд д дд    ввв    дд д дд д дд    дд д дд д дд    ввв    дд д дд д дд   с
с дд д дд д дд    ввв    дд д дд д дд    дд д дд д дд    ввв    дд д дд д дд   с
с дд д дд д дд    ввв    дд д дд д дд    дд д дд д дд    ввв    дд д дд д дд   с
с дд   дд   дд     c     дд   дд   дд    дд   дд   дд     c     дд   дд   дд   с
с дд дддддд дд    ввв    дд дддддд дд    дд дддддд дд    ввв    дд дддддд дд   с
с дт        тд    ввв    дт        тд    дт        тд    ввв    дт        тд   с
с д дддддддд д    ввв    д дддддддд д    д дддддддд д    ввв    д дддддддд д   с
с                       			                               с
сс дд дддттттд    ввв    дттттддд дд с  с дд дддттттд    ввв    дттттддд дд с  с
с        ттттд    ввв  	 дтттт                  ттттд    ввв  	дтттт          с
с   д  д ттттд    ввв    дтттт	д  д       д  д ттттд    ввв    дтттт	д  д   с
с   д  д           c       		д  д       д  д           c     д  д   с
с   д  д  двттвд  ввв  двттвд 	д  д       д  д  двттвд  ввв   двттвд 	д  д   с
с   д  д  дттттд  ввв  дттттд 	д  д       д  д  дттттд  ввв   дттттд 	д  д   с
с   д  д   тттт   ввв   тттт  	д  д       д  д   тттт   ввв    тттт  	д  д   с
с	  дттттд       дттттд                    дттттд        дттттд          с
с          тттт                                                 тттт           с
с  вввввв  тттт  вввв                                    вввв   тттт   вввввв  с
с  вввввв  тттт  вввв                                    вввв   тттт   вввввв  с
с          тттт                                                 тттт           с
с         дттттд        дттттд                   дттттд        дттттд          с
с   д  д   тттт   ввв    тттт 	д  д       д  д   тттт   ввв    тттт 	д  д   с
с   д  д  дттттд  ввв   дттттд	д  д       д  д  дттттд  ввв   дттттд	д  д   с
с   д  д  двттвд  ввв   двттвд	д  д       д  д  двттвд  ввв   двттвд	д  д   с
с   д  д           c            д  д       д  д           c    		д  д   с
с   д  д ттттд    ввв    дтттт	д  д       д  д ттттд    ввв    дтттт	д  д   с
с        ттттд    ввв    дтттт	                ттттд    ввв    дтттт	       с
сс дд дддттттд    ввв    дттттддд дд с  с дд дддттттд    ввв    дттттддд дд   сс
с                       			                               с
с д дддддддд д    ввв    д дддддддд д    д дддддддд д    ввв    д дддддддд д   с
с дт        тд    ввв    дт        тд    дт        тд    ввв    дт        тд   с
с дд дддддд дд    ввв    дд дддддд дд    дд дддддд дд    ввв    дд дддддд дд   с
с дд   дд   дд     c     дд   дд   дд    дд   дд   дд     c     дд   дд   дд   с
с дд д дд д дд    ввв    дд д дд д дд    дд д дд д дд    ввв    дд д дд д дд   с
с дд д дд д дд    ввв    дд д дд д дд    дд д дд д дд    ввв    дд д дд д дд   с
с дд д дд д дд    ввв    дд д дд д дд    дд д дд д дд    ввв    дд д дд д дд   с
с дд д    д дд           дд д    д дд    дд д    д дд           дд д    д дд   с
с дд сттттс дд    ввв    дд сттттс дд    дд сттттс дд    ввв    дд сттттс дд   с
с дд тттттт дд    ввв    дд тттттт дд    дд тттттт дд    ввв    дд тттттт дд   с
с дд сттттс дд    ввв    дд сттттс дд    дд сттттс дд    ввв    дд сттттс дд   с
с дд д    д дд           дд д    д дд    дд д    д дд           дд д    д дд   с
с дд д дд д дд    ввв    дд д дд д дд    дд д дд д дд    ввв    дд д дд д дд   с
с дд д дд д дд    ввв    дд д дд д дд    дд д дд д дд    ввв    дд д дд д дд   с
с дд д дд д дд    ввв    дд д дд д дд    дд д дд д дд    ввв    дд д дд д дд   с
с дд   дд   дд     c     дд   дд   дд    дд   дд   дд     c     дд   дд   дд   с
с дд дддддд дд    ввв    дд дддддд дд    дд дддддд дд    ввв    дд дддддд дд   с
с дт        тд    ввв    дт        тд    дт        тд    ввв    дт        тд   с
с д дддддддд д    ввв    д дддддддд д    д дддддддд д    ввв    д дддддддд д   с
с                       			                               с
сс дд дддттттд    ввв    дттттддд дд с  с дд дддттттд    ввв    дттттддд дд с  с
с        ттттд    ввв  	 дтттт                  ттттд    ввв  	дтттт          с
с   д  д ттттд    ввв    дтттт	д  д       д  д ттттд    ввв    дтттт	д  д   с
с   д  д           c       		д  д       д  д           c     д  д   с
с   д  д  двттвд  ввв  двттвд 	д  д       д  д  двттвд  ввв  двттвд 	д  д   с
с   д  д  дттттд  ввв  дттттд 	д  д       д  д  дттттд  ввв  дттттд 	д  д   с
с   д  д   тттт   ввв   тттт  	д  д       д  д   тттт   ввв   тттт  	д  д   с
с	  дттттд       дттттд                    дттттд       дттттд           с
ссссссссссссссссссссссссссссссссссссссссссссссссссссссссссссссссссссссссссссссcc