ссссссссссссс
с        *  с
с *  *      с
с           с
с  тт       с
с  тт    *  с
с        *  с
ссссссссссссс