сссссссссссссссссссссссссссссссссссссссс
с                                      с
с       вввв    д      д    тт    тт   с
с     ввв       д      д               с
с    вв         д      д      в в      с
с    вв         дттттттд      в в      с
с     ввв       дттттттд    ввввввв    с
с       вввв    дттттттд      ввв      с
с               д      д    ввввввв    с
с                             в в      с
с    тт    тт                 в в      с
с                                      с
с                                      с
сдд  дддддд  дд         дд   дддддд  ддс
сдд  дддддд  дд         дд   дддддд  ддс
с            дд         дд             с
с                                      с
с    дд                         дд     с
с    дд                         дд     с
с    дд      дд         дд      дд     с
с    дд      дд         дд      дд     с
с    дд      дд         дд      дд     с
с    дд      дд         дд      дд     с
с    дд      дд         дд      дд     с
с    дд                         дд     с
с    дд                         дд     с
с    дд                         дд     с
с                                      с
c ддддвдссссдссссдддсдддссдддссдвдддд  c
с дддвддсддддсддсддсдсддсдсдсдсддвддд  c
c ддвдддссссдссссдсссссдсддсддсдддвдд  c
c дддвддсддддсддддсдддсдсдддддсддвддд  c
c ддддвдссссдсддддсдддсдсдддддсдвдддд  c
с                                      с
с  т         т           т         т   с
с   т  тт   т             т  тт   т    с
с    т  т  т               т  т  т     с
с   ттттттттт дд      дд  ттттттттт    с
с     т т т   дд      дд    т т т      с
с    т     т  дд      дд   т     т     с
сссссссссссссссссссссссссссссссссссссссс